Season,Team,G,W,L,T,W_L_Per,Pts,PtsO,PtDif
2007,NWE,16,16,0,0,1,589,274,315
2015,CAR,16,15,1,0,0.938,500,308,192
2011,GNB,16,15,1,0,0.938,560,359,201
2004,PIT,16,15,1,0,0.938,372,251,121
2022,PHI,17,14,3,0,0.824,477,344,133
2022,KAN,17,14,3,0,0.824,496,369,127
2020,KAN,16,14,2,0,0.875,473,362,111
2019,BAL,16,14,2,0,0.875,531,282,249
2016,NWE,16,14,2,0,0.875,441,250,191
2010,NWE,16,14,2,0,0.875,518,313,205
2009,IND,16,14,2,0,0.875,416,307,109
2006,SDG,16,14,2,0,0.875,492,303,189
2005,IND,16,14,2,0,0.875,439,247,192
2004,NWE,16,14,2,0,0.875,437,260,177
2003,NWE,16,14,2,0,0.875,348,238,110
2001,STL,16,14,2,0,0.875,503,273,230
1999,JAX,16,14,2,0,0.875,396,217,179
2023,BAL,17,13,4,0,0.765,483,280,203
2022,SFO,17,13,4,0,0.765,450,277,173
2022,MIN,17,13,4,0,0.765,424,427,-3
2022,BUF,16,13,3,0,0.813,455,286,169
2021,GNB,17,13,4,0,0.765,450,371,79
2021,TAM,17,13,4,0,0.765,511,353,158
2020,BUF,16,13,3,0,0.813,501,375,126
2020,GNB,16,13,3,0,0.813,509,369,140
2019,GNB,16,13,3,0,0.813,376,313,63
2019,NOR,16,13,3,0,0.813,458,341,117
2019,SFO,16,13,3,0,0.813,479,310,169
2018,NOR,16,13,3,0,0.813,504,353,151
2018,LAR,16,13,3,0,0.813,527,384,143
2017,MIN,16,13,3,0,0.813,382,252,130
2017,NWE,16,13,3,0,0.813,458,296,162
2017,PHI,16,13,3,0,0.813,457,295,162
2017,PIT,16,13,3,0,0.813,406,308,98
2016,DAL,16,13,3,0,0.813,421,306,115
2015,ARI,16,13,3,0,0.813,489,313,176
2013,SEA,16,13,3,0,0.813,417,231,186
2013,DEN,16,13,3,0,0.813,606,399,207
2012,DEN,16,13,3,0,0.813,481,289,192
2012,ATL,16,13,3,0,0.813,419,299,120
2011,SFO,16,13,3,0,0.813,380,229,151
2011,NWE,16,13,3,0,0.813,513,342,171
2011,NOR,16,13,3,0,0.813,547,339,208
2010,ATL,16,13,3,0,0.813,414,288,126
2009,SDG,16,13,3,0,0.813,454,320,134
2009,NOR,16,13,3,0,0.813,510,341,169
2008,TEN,16,13,3,0,0.813,375,234,141
2007,GNB,16,13,3,0,0.813,435,291,144
2007,DAL,16,13,3,0,0.813,455,325,130
2007,IND,16,13,3,0,0.813,450,262,188
2006,CHI,16,13,3,0,0.813,427,255,172
2006,BAL,16,13,3,0,0.813,353,201,152
2005,SEA,16,13,3,0,0.813,452,271,181
2005,DEN,16,13,3,0,0.813,395,258,137
2004,PHI,16,13,3,0,0.813,386,260,126
2003,KAN,16,13,3,0,0.813,484,332,152
2001,CHI,16,13,3,0,0.813,338,203,135
2001,PIT,16,13,3,0,0.813,352,212,140
2000,TEN,16,13,3,0,0.813,346,191,155
1999,IND,16,13,3,0,0.813,423,333,90
1999,TEN,16,13,3,0,0.813,392,324,68
1999,STL,16,13,3,0,0.813,526,242,284
2023,SFO,17,12,5,0,0.706,491,298,193
2023,DET,17,12,5,0,0.706,461,395,66
2023,DAL,17,12,5,0,0.706,509,315,194
2022,DAL,17,12,5,0,0.706,467,342,125
2022,CIN,16,12,4,0,0.75,418,322,96
2021,KAN,17,12,5,0,0.706,480,364,116
2021,DAL,17,12,5,0,0.706,530,358,172
2021,TEN,17,12,5,0,0.706,419,354,65
2021,LAR,17,12,5,0,0.706,460,372,88
2020,NOR,16,12,4,0,0.75,482,337,145
2020,PIT,16,12,4,0,0.75,416,312,104
2020,SEA,16,12,4,0,0.75,459,371,88
2019,KAN,16,12,4,0,0.75,451,308,143
2019,NWE,16,12,4,0,0.75,420,225,195
2018,CHI,16,12,4,0,0.75,421,283,138
2018,KAN,16,12,4,0,0.75,565,421,144
2018,LAC,16,12,4,0,0.75,428,329,99
2016,KAN,16,12,4,0,0.75,389,311,78
2016,OAK,16,12,4,0,0.75,416,385,31
2015,NWE,16,12,4,0,0.75,465,315,150
2015,DEN,16,12,4,0,0.75,355,296,59
2015,CIN,16,12,4,0,0.75,419,279,140
2014,SEA,16,12,4,0,0.75,394,254,140
2014,NWE,16,12,4,0,0.75,468,313,155
2014,GNB,16,12,4,0,0.75,486,348,138
2014,DEN,16,12,4,0,0.75,482,354,128
2014,DAL,16,12,4,0,0.75,467,352,115
2013,SFO,16,12,4,0,0.75,406,272,134
2013,NWE,16,12,4,0,0.75,444,338,106
2013,CAR,16,12,4,0,0.75,366,241,125
2012,NWE,16,12,4,0,0.75,557,331,226
2012,HOU,16,12,4,0,0.75,416,331,85
2011,BAL,16,12,4,0,0.75,378,266,112
2011,PIT,16,12,4,0,0.75,325,227,98
2010,BAL,16,12,4,0,0.75,357,270,87
2010,PIT,16,12,4,0,0.75,375,232,143
2009,MIN,16,12,4,0,0.75,470,312,158
2008,PIT,16,12,4,0,0.75,347,223,124
2008,NYG,16,12,4,0,0.75,427,294,133
2008,IND,16,12,4,0,0.75,377,298,79
2008,CAR,16,12,4,0,0.75,414,329,85
2006,IND,16,12,4,0,0.75,427,360,67
2006,NWE,16,12,4,0,0.75,385,237,148
2005,JAX,16,12,4,0,0.75,361,269,92
2004,IND,16,12,4,0,0.75,522,351,171
2004,SDG,16,12,4,0,0.75,446,313,133
2003,IND,16,12,4,0,0.75,447,336,111
2003,TEN,16,12,4,0,0.75,435,324,111
2003,PHI,16,12,4,0,0.75,374,287,87
2003,STL,16,12,4,0,0.75,447,328,119
2002,GNB,16,12,4,0,0.75,398,328,70
2002,PHI,16,12,4,0,0.75,415,241,174
2002,TAM,16,12,4,0,0.75,346,196,150
2001,GNB,16,12,4,0,0.75,390,266,124
2001,SFO,16,12,4,0,0.75,409,282,127
2000,NYG,16,12,4,0,0.75,328,246,82
2000,OAK,16,12,4,0,0.75,479,299,180
2000,BAL,16,12,4,0,0.75,333,165,168
2023,PHI,17,11,6,0,0.647,433,428,5
2023,MIA,17,11,6,0,0.647,496,391,105
2023,KAN,17,11,6,0,0.647,371,294,77
2023,CLE,17,11,6,0,0.647,396,362,34
2023,BUF,17,11,6,0,0.647,451,311,140
2021,ARI,17,11,6,0,0.647,449,366,83
2021,BUF,17,11,6,0,0.647,483,289,194
2020,CLE,16,11,5,0,0.688,408,419,-11
2020,IND,16,11,5,0,0.688,451,362,89
2020,TAM,16,11,5,0,0.688,492,355,137
2020,TEN,16,11,5,0,0.688,491,439,52
2020,BAL,16,11,5,0,0.688,468,303,165
2019,SEA,16,11,5,0,0.688,405,398,7
2018,HOU,16,11,5,0,0.688,402,316,86
2018,NWE,16,11,5,0,0.688,436,325,111
2017,CAR,16,11,5,0,0.688,363,327,36
2017,NOR,16,11,5,0,0.688,448,326,122
2017,LAR,16,11,5,0,0.688,478,329,149
2016,ATL,16,11,5,0,0.688,540,406,134
2016,NYG,16,11,5,0,0.688,310,284,26
2016,PIT,16,11,5,0,0.688,399,327,72
2015,MIN,16,11,5,0,0.688,365,302,63
2015,KAN,16,11,5,0,0.688,405,287,118
2014,PIT,16,11,5,0,0.688,436,368,68
2014,DET,16,11,5,0,0.688,321,282,39
2014,ARI,16,11,5,0,0.688,310,299,11
2014,IND,16,11,5,0,0.688,458,369,89
2013,NOR,16,11,5,0,0.688,414,304,110
2013,KAN,16,11,5,0,0.688,430,305,125
2013,IND,16,11,5,0,0.688,391,336,55
2013,CIN,16,11,5,0,0.688,430,305,125
2012,SFO,16,11,4,1,0.719,397,273,124
2012,SEA,16,11,5,0,0.688,412,245,167
2012,GNB,16,11,5,0,0.688,433,336,97
2012,IND,16,11,5,0,0.688,357,387,-30
2010,NYJ,16,11,5,0,0.688,367,304,63
2010,NOR,16,11,5,0,0.688,384,307,77
2010,CHI,16,11,5,0,0.688,334,286,48
2009,PHI,16,11,5,0,0.688,429,337,92
2009,GNB,16,11,5,0,0.688,461,297,164
2009,DAL,16,11,5,0,0.688,361,250,111
2008,BAL,16,11,5,0,0.688,385,244,141
2008,NWE,16,11,5,0,0.688,410,309,101
2008,MIA,16,11,5,0,0.688,345,317,28
2008,ATL,16,11,5,0,0.688,391,325,66
2007,SDG,16,11,5,0,0.688,412,284,128
2007,JAX,16,11,5,0,0.688,411,304,107
2005,NYG,16,11,5,0,0.688,422,314,108
2005,PIT,16,11,5,0,0.688,389,258,131
2005,TAM,16,11,5,0,0.688,300,274,26
2005,CIN,16,11,5,0,0.688,421,350,71
2005,CHI,16,11,5,0,0.688,260,202,58
2005,CAR,16,11,5,0,0.688,391,259,132
2004,ATL,16,11,5,0,0.688,340,337,3
2003,CAR,16,11,5,0,0.688,325,304,21
2002,TEN,16,11,5,0,0.688,367,324,43
2002,OAK,16,11,5,0,0.688,450,304,146
2001,MIA,16,11,5,0,0.688,344,290,54
2001,NWE,16,11,5,0,0.688,371,272,99
2001,PHI,16,11,5,0,0.688,343,208,135
2000,DEN,16,11,5,0,0.688,485,369,116
2000,MIA,16,11,5,0,0.688,323,226,97
2000,MIN,16,11,5,0,0.688,397,371,26
2000,PHI,16,11,5,0,0.688,351,245,106
1999,BUF,16,11,5,0,0.688,320,229,91
1999,TAM,16,11,5,0,0.688,270,235,35
2023,HOU,17,10,7,0,0.588,377,353,24
2023,PIT,17,10,7,0,0.588,304,324,-20
2023,LAR,17,10,7,0,0.588,404,377,27
2022,LAC,17,10,7,0,0.588,391,384,7
2022,BAL,17,10,7,0,0.588,350,315,35
2021,NWE,17,10,7,0,0.588,462,303,159
2021,SFO,17,10,7,0,0.588,427,365,62
2021,CIN,17,10,7,0,0.588,460,376,84
2021,LVR,17,10,7,0,0.588,374,439,-65
2020,LAR,16,10,6,0,0.625,372,296,76
2020,MIA,16,10,6,0,0.625,404,338,66
2019,MIN,16,10,6,0,0.625,407,303,104
2019,BUF,16,10,6,0,0.625,314,259,55
2019,HOU,16,10,6,0,0.625,378,385,-7
2018,IND,16,10,6,0,0.625,433,344,89
2018,DAL,16,10,6,0,0.625,339,324,15
2018,BAL,16,10,6,0,0.625,389,287,102
2018,SEA,16,10,6,0,0.625,428,347,81
2017,ATL,16,10,6,0,0.625,353,315,38
2017,JAX,16,10,6,0,0.625,417,268,149
2017,KAN,16,10,6,0,0.625,415,339,76
2016,GNB,16,10,6,0,0.625,432,388,44
2016,MIA,16,10,6,0,0.625,363,380,-17
2016,SEA,16,10,5,1,0.656,354,292,62
2015,SEA,16,10,6,0,0.625,423,277,146
2015,PIT,16,10,6,0,0.625,423,319,104
2015,NYJ,16,10,6,0,0.625,387,314,73
2015,GNB,16,10,6,0,0.625,368,323,45
2014,BAL,16,10,6,0,0.625,409,302,107
2014,PHI,16,10,6,0,0.625,474,400,74
2014,CIN,16,10,5,1,0.656,365,344,21
2013,PHI,16,10,6,0,0.625,442,382,60
2013,ARI,16,10,6,0,0.625,379,324,55
2012,WAS,16,10,6,0,0.625,436,388,48
2012,BAL,16,10,6,0,0.625,398,344,54
2012,MIN,16,10,6,0,0.625,379,348,31
2012,CIN,16,10,6,0,0.625,391,320,71
2012,CHI,16,10,6,0,0.625,375,277,98
2011,HOU,16,10,6,0,0.625,381,278,103
2011,DET,16,10,6,0,0.625,474,387,87
2011,ATL,16,10,6,0,0.625,402,350,52
2010,TAM,16,10,6,0,0.625,341,318,23
2010,PHI,16,10,6,0,0.625,439,377,62
2010,NYG,16,10,6,0,0.625,394,347,47
2010,KAN,16,10,6,0,0.625,366,326,40
2010,GNB,16,10,6,0,0.625,388,240,148
2010,IND,16,10,6,0,0.625,435,388,47
2009,NWE,16,10,6,0,0.625,427,285,142
2009,ARI,16,10,6,0,0.625,375,325,50
2009,CIN,16,10,6,0,0.625,305,291,14
2008,MIN,16,10,6,0,0.625,379,333,46
2007,SEA,16,10,6,0,0.625,393,291,102
2007,PIT,16,10,6,0,0.625,393,269,124
2007,TEN,16,10,6,0,0.625,301,297,4
2007,NYG,16,10,6,0,0.625,373,351,22
2007,CLE,16,10,6,0,0.625,402,382,20
2006,NOR,16,10,6,0,0.625,413,322,91
2006,NYJ,16,10,6,0,0.625,316,295,21
2006,PHI,16,10,6,0,0.625,398,328,70
2005,NWE,16,10,6,0,0.625,379,338,41
2005,WAS,16,10,6,0,0.625,359,293,66
2005,KAN,16,10,6,0,0.625,403,325,78
2004,NYJ,16,10,6,0,0.625,333,261,72
2004,GNB,16,10,6,0,0.625,424,380,44
2004,DEN,16,10,6,0,0.625,381,304,77
2003,SEA,16,10,6,0,0.625,404,327,77
2003,BAL,16,10,6,0,0.625,391,281,110
2003,MIA,16,10,6,0,0.625,311,261,50
2003,GNB,16,10,6,0,0.625,442,307,135
2003,DEN,16,10,6,0,0.625,381,301,80
2003,DAL,16,10,6,0,0.625,289,260,29
2002,IND,16,10,6,0,0.625,349,313,36
2002,NYG,16,10,6,0,0.625,320,279,41
2002,PIT,16,10,5,1,0.656,390,345,45
2002,SFO,16,10,6,0,0.625,367,351,16
2001,NYJ,16,10,6,0,0.625,308,295,13
2001,OAK,16,10,6,0,0.625,399,327,72
2001,BAL,16,10,6,0,0.625,303,265,38
2000,TAM,16,10,6,0,0.625,388,269,119
2000,STL,16,10,6,0,0.625,540,471,69
2000,NOR,16,10,6,0,0.625,354,305,49
2000,IND,16,10,6,0,0.625,429,326,103
1999,MIN,16,10,6,0,0.625,399,335,64
1999,WAS,16,10,6,0,0.625,443,377,66
2023,GNB,17,9,8,0,0.529,383,350,33
2023,JAX,17,9,8,0,0.529,377,371,6
2023,IND,17,9,8,0,0.529,396,415,-19
2023,CIN,17,9,8,0,0.529,366,384,-18
2023,NOR,17,9,8,0,0.529,402,327,75
2023,TAM,17,9,8,0,0.529,348,325,23
2023,SEA,17,9,8,0,0.529,364,402,-38
2022,SEA,17,9,8,0,0.529,407,401,6
2022,DET,17,9,8,0,0.529,453,427,26
2022,JAX,17,9,8,0,0.529,404,350,54
2022,MIA,17,9,8,0,0.529,397,399,-2
2022,PIT,17,9,8,0,0.529,308,346,-38
2022,NYG,17,9,7,1,0.559,365,371,-6
2021,NOR,17,9,8,0,0.529,364,335,29
2021,MIA,17,9,8,0,0.529,341,373,-32
2021,IND,17,9,8,0,0.529,451,365,86
2021,LAC,17,9,8,0,0.529,474,459,15
2021,PHI,17,9,8,0,0.529,444,385,59
2021,PIT,17,9,7,1,0.559,343,398,-55
2019,LAR,16,9,7,0,0.563,394,364,30
2019,TEN,16,9,7,0,0.563,402,331,71
2019,PHI,16,9,7,0,0.563,385,354,31
2018,TEN,16,9,7,0,0.563,310,303,7
2018,PHI,16,9,7,0,0.563,367,348,19
2018,PIT,16,9,6,1,0.594,428,360,68
2017,BAL,16,9,7,0,0.563,395,303,92
2017,LAC,16,9,7,0,0.563,355,272,83
2017,TEN,16,9,7,0,0.563,334,356,-22
2017,SEA,16,9,7,0,0.563,366,332,34
2017,DET,16,9,7,0,0.563,410,376,34
2017,DAL,16,9,7,0,0.563,354,332,22
2017,BUF,16,9,7,0,0.563,302,359,-57
2016,DET,16,9,7,0,0.563,346,358,-12
2016,DEN,16,9,7,0,0.563,333,297,36
2016,HOU,16,9,7,0,0.563,279,328,-49
2016,TEN,16,9,7,0,0.563,381,378,3
2016,TAM,16,9,7,0,0.563,354,369,-15
2015,WAS,16,9,7,0,0.563,388,379,9
2015,HOU,16,9,7,0,0.563,339,313,26
2014,BUF,16,9,7,0,0.563,343,289,54
2014,HOU,16,9,7,0,0.563,372,307,65
2014,KAN,16,9,7,0,0.563,353,281,72
2014,SDG,16,9,7,0,0.563,348,348,0
2013,SDG,16,9,7,0,0.563,396,348,48
2012,NYG,16,9,7,0,0.563,429,344,85
2011,TEN,16,9,7,0,0.563,325,317,8
2011,NYG,16,9,7,0,0.563,394,400,-6
2011,CIN,16,9,7,0,0.563,344,323,21
2010,SDG,16,9,7,0,0.563,441,322,119
2009,ATL,16,9,7,0,0.563,363,325,38
2009,HOU,16,9,7,0,0.563,388,333,55
2009,NYJ,16,9,7,0,0.563,348,236,112
2009,BAL,16,9,7,0,0.563,391,261,130
2009,PIT,16,9,7,0,0.563,368,324,44
2008,CHI,16,9,7,0,0.563,375,350,25
2008,ARI,16,9,7,0,0.563,427,426,1
2008,DAL,16,9,7,0,0.563,362,365,-3
2008,NYJ,16,9,7,0,0.563,405,356,49
2008,PHI,16,9,6,1,0.594,416,289,127
2008,TAM,16,9,7,0,0.563,361,323,38
2007,TAM,16,9,7,0,0.563,334,270,64
2007,WAS,16,9,7,0,0.563,334,310,24
2006,SEA,16,9,7,0,0.563,335,341,-6
2006,DAL,16,9,7,0,0.563,425,350,75
2006,DEN,16,9,7,0,0.563,319,305,14
2006,KAN,16,9,7,0,0.563,331,315,16
2005,DAL,16,9,7,0,0.563,325,308,17
2005,MIN,16,9,7,0,0.563,306,344,-38
2005,SDG,16,9,7,0,0.563,418,312,106
2005,MIA,16,9,7,0,0.563,318,317,1
2004,BAL,16,9,7,0,0.563,317,268,49
2004,JAX,16,9,7,0,0.563,261,280,-19
2004,SEA,16,9,7,0,0.563,371,373,-2
2004,BUF,16,9,7,0,0.563,395,284,111
2003,MIN,16,9,7,0,0.563,416,353,63
2002,NYJ,16,9,7,0,0.563,359,336,23
2002,NWE,16,9,7,0,0.563,381,346,35
2002,NOR,16,9,7,0,0.563,432,388,44
2002,ATL,16,9,6,1,0.594,402,314,88
2002,MIA,16,9,7,0,0.563,378,301,77
2002,DEN,16,9,7,0,0.563,392,344,48
2002,CLE,16,9,7,0,0.563,344,320,24
2001,SEA,16,9,7,0,0.563,301,324,-23
2001,TAM,16,9,7,0,0.563,324,280,44
2000,NYJ,16,9,7,0,0.563,321,321,0
2000,GNB,16,9,7,0,0.563,353,323,30
2000,DET,16,9,7,0,0.563,307,307,0
2000,PIT,16,9,7,0,0.563,321,255,66
1999,SEA,16,9,7,0,0.563,338,298,40
1999,KAN,16,9,7,0,0.563,390,322,68
1999,MIA,16,9,7,0,0.563,326,336,-10
2023,DEN,17,8,9,0,0.471,357,413,-56
2023,LVR,17,8,9,0,0.471,332,331,1
2022,NWE,17,8,9,0,0.471,364,347,17
2022,GNB,17,8,9,0,0.471,370,371,-1
2022,WAS,17,8,8,1,0.5,321,343,-22
2022,TAM,17,8,9,0,0.471,313,358,-45
2021,MIN,17,8,9,0,0.471,425,426,-1
2021,BAL,17,8,9,0,0.471,387,392,-5
2021,CLE,17,8,9,0,0.471,349,371,-22
2020,LVR,16,8,8,0,0.5,434,478,-44
2020,CHI,16,8,8,0,0.5,372,370,2
2020,ARI,16,8,8,0,0.5,410,367,43
2019,PIT,16,8,8,0,0.5,289,303,-14
2019,DAL,16,8,8,0,0.5,434,321,113
2019,CHI,16,8,8,0,0.5,280,298,-18
2018,MIN,16,8,7,1,0.531,360,341,19
2017,ARI,16,8,8,0,0.5,295,361,-66
2016,WAS,16,8,7,1,0.531,396,383,13
2016,IND,16,8,8,0,0.5,411,392,19
2016,MIN,16,8,8,0,0.5,327,307,20
2016,BAL,16,8,8,0,0.5,343,321,22
2015,ATL,16,8,8,0,0.5,339,345,-6
2015,BUF,16,8,8,0,0.5,379,359,20
2015,IND,16,8,8,0,0.5,333,408,-75
2014,SFO,16,8,8,0,0.5,306,340,-34
2014,MIA,16,8,8,0,0.5,388,373,15
2013,NYJ,16,8,8,0,0.5,290,387,-97
2013,PIT,16,8,8,0,0.5,379,370,9
2013,BAL,16,8,8,0,0.5,320,352,-32
2013,MIA,16,8,8,0,0.5,317,335,-18
2013,DAL,16,8,8,0,0.5,439,432,7
2013,GNB,16,8,7,1,0.531,417,428,-11
2013,CHI,16,8,8,0,0.5,445,478,-33
2012,DAL,16,8,8,0,0.5,376,400,-24
2012,PIT,16,8,8,0,0.5,336,314,22
2011,NYJ,16,8,8,0,0.5,377,363,14
2011,CHI,16,8,8,0,0.5,353,341,12
2011,SDG,16,8,8,0,0.5,406,377,29
2011,PHI,16,8,8,0,0.5,396,328,68
2005,PHI,16,6,10,0,0.375,310,388,-78
2005,CLE,16,6,10,0,0.375,232,301,-69
2006,MIN,16,6,10,0,0.375,282,327,-45
2006,MIA,16,6,10,0,0.375,260,283,-23
2006,HOU,16,6,10,0,0.375,267,366,-99
2008,GNB,16,6,10,0,0.375,419,380,39
2009,BUF,16,6,10,0,0.375,258,326,-68
2010,WAS,16,6,10,0,0.375,302,377,-75
2010,SFO,16,6,10,0,0.375,305,346,-41
2010,TEN,16,6,10,0,0.375,356,339,17
2010,MIN,16,6,10,0,0.375,281,348,-67
2010,HOU,16,6,10,0,0.375,390,427,-37
2010,DET,16,6,10,0,0.375,362,369,-7
2010,DAL,16,6,10,0,0.375,394,436,-42
2011,MIA,16,6,10,0,0.375,329,313,16
2011,CAR,16,6,10,0,0.375,406,429,-23
2011,BUF,16,6,10,0,0.375,372,434,-62
2012,TEN,16,6,10,0,0.375,330,471,-141
2012,NYJ,16,6,10,0,0.375,281,375,-94
2012,BUF,16,6,10,0,0.375,344,435,-91
2013,BUF,16,6,10,0,0.375,339,388,-49
2014,STL,16,6,10,0,0.375,324,354,-30
2014,NYG,16,6,10,0,0.375,380,400,-20
2014,ATL,16,6,10,0,0.375,381,417,-36
2015,TAM,16,6,10,0,0.375,342,417,-75
2015,NYG,16,6,10,0,0.375,420,442,-22
2015,MIA,16,6,10,0,0.375,310,389,-79
2015,CHI,16,6,10,0,0.375,335,397,-62
2016,CIN,16,6,9,1,0.406,325,315,10
2016,CAR,16,6,10,0,0.375,369,402,-33
2017,SFO,16,6,10,0,0.375,331,383,-52
2017,OAK,16,6,10,0,0.375,301,373,-72
2017,MIA,16,6,10,0,0.375,281,393,-112
2018,GNB,16,6,9,1,0.406,376,400,-24
2018,DET,16,6,10,0,0.375,324,360,-36
2018,DEN,16,6,10,0,0.375,329,349,-20
2018,CIN,16,6,10,0,0.375,368,455,-87
2018,BUF,16,6,10,0,0.375,269,374,-105
2019,JAX,16,6,10,0,0.375,300,397,-97
2019,CLE,16,6,10,0,0.375,335,393,-58
2020,SFO,16,6,10,0,0.375,376,390,-14
2020,NYG,16,6,10,0,0.375,280,357,-77
2020,DAL,16,6,10,0,0.375,395,473,-78
2021,CHI,17,6,11,0,0.353,311,407,-96
2022,LVR,17,6,11,0,0.353,395,418,-23
2023,TEN,17,6,11,0,0.353,305,367,-62
2023,NYG,17,6,11,0,0.353,266,407,-141
2024,WAS,8,6,2,0,0.75,236,167,69
2024,HOU,8,6,2,0,0.75,188,179,9
2024,GNB,8,6,2,0,0.75,216,170,46
2024,DET,7,6,1,0,0.857,234,134,100
2024,BUF,8,6,2,0,0.75,230,146,84
1999,NYG,16,7,9,0,0.438,299,358,-59
2000,KAN,16,7,9,0,0.438,355,354,1
2000,JAX,16,7,9,0,0.438,367,327,40
2000,CAR,16,7,9,0,0.438,310,310,0
2001,TEN,16,7,9,0,0.438,336,388,-52
2001,NYG,16,7,9,0,0.438,294,321,-27
2001,NOR,16,7,9,0,0.438,333,409,-76
2001,ARI,16,7,9,0,0.438,295,343,-48
2001,CLE,16,7,9,0,0.438,285,319,-34
2001,ATL,16,7,9,0,0.438,291,377,-86
2002,WAS,16,7,9,0,0.438,307,365,-58
2002,SEA,16,7,9,0,0.438,355,369,-14
2002,BAL,16,7,9,0,0.438,316,354,-38
2002,STL,16,7,9,0,0.438,316,369,-53
2002,CAR,16,7,9,0,0.438,258,302,-44
2003,TAM,16,7,9,0,0.438,301,264,37
2003,SFO,16,7,9,0,0.438,384,337,47
2003,CHI,16,7,9,0,0.438,283,346,-63
2004,KAN,16,7,9,0,0.438,483,435,48
2004,HOU,16,7,9,0,0.438,309,339,-30
2004,CAR,16,7,9,0,0.438,355,339,16
2006,SFO,16,7,9,0,0.438,298,412,-114
2006,BUF,16,7,9,0,0.438,300,311,-11
2006,ATL,16,7,9,0,0.438,292,328,-36
2007,NOR,16,7,9,0,0.438,379,388,-9
2007,DET,16,7,9,0,0.438,346,444,-98
2007,DEN,16,7,9,0,0.438,320,409,-89
2007,CIN,16,7,9,0,0.438,380,385,-5
2007,CHI,16,7,9,0,0.438,334,348,-14
2007,CAR,16,7,9,0,0.438,267,347,-80
2007,BUF,16,7,9,0,0.438,252,354,-102
2008,SFO,16,7,9,0,0.438,339,381,-42
2008,BUF,16,7,9,0,0.438,336,342,-6
2009,MIA,16,7,9,0,0.438,360,390,-30
2009,JAX,16,7,9,0,0.438,290,380,-90
2009,CHI,16,7,9,0,0.438,327,375,-48
2010,SEA,16,7,9,0,0.438,310,407,-97
2010,STL,16,7,9,0,0.438,289,328,-39
2010,MIA,16,7,9,0,0.438,273,333,-60
2011,SEA,16,7,9,0,0.438,321,315,6
2011,KAN,16,7,9,0,0.438,212,338,-126
2012,TAM,16,7,9,0,0.438,389,394,-5
2012,SDG,16,7,9,0,0.438,350,350,0
2012,STL,16,7,8,1,0.469,299,348,-49
2012,NOR,16,7,9,0,0.438,461,454,7
2012,MIA,16,7,9,0,0.438,288,317,-29
2012,CAR,16,7,9,0,0.438,357,363,-6
2013,STL,16,7,9,0,0.438,348,364,-16
2013,TEN,16,7,9,0,0.438,362,381,-19
2013,NYG,16,7,9,0,0.438,294,383,-89
2013,DET,16,7,9,0,0.438,395,376,19
2014,NOR,16,7,9,0,0.438,401,424,-23
2014,MIN,16,7,9,0,0.438,325,343,-18
2014,CLE,16,7,9,0,0.438,299,337,-38
2014,CAR,16,7,8,1,0.469,339,374,-35
2015,STL,16,7,9,0,0.438,280,330,-50
2015,OAK,16,7,9,0,0.438,359,399,-40
2015,PHI,16,7,9,0,0.438,377,430,-53
2015,NOR,16,7,9,0,0.438,408,476,-68
2015,DET,16,7,9,0,0.438,358,400,-42
2016,PHI,16,7,9,0,0.438,367,331,36
2016,NOR,16,7,9,0,0.438,469,454,15
2016,ARI,16,7,8,1,0.469,418,362,56
2016,BUF,16,7,9,0,0.438,399,378,21
2017,WAS,16,7,9,0,0.438,342,388,-46
2017,GNB,16,7,9,0,0.438,320,384,-64
2017,CIN,16,7,9,0,0.438,290,349,-59
2018,WAS,16,7,9,0,0.438,281,359,-78
2018,MIA,16,7,9,0,0.438,319,433,-114
2018,CLE,16,7,8,1,0.469,359,392,-33
2018,CAR,16,7,9,0,0.438,376,382,-6
2018,ATL,16,7,9,0,0.438,414,423,-9
2019,TAM,16,7,9,0,0.438,458,449,9
2019,OAK,16,7,9,0,0.438,313,419,-106
2019,NYJ,16,7,9,0,0.438,276,359,-83
2019,DEN,16,7,9,0,0.438,282,316,-34
2019,IND,16,7,9,0,0.438,361,373,-12
2019,ATL,16,7,9,0,0.438,381,399,-18
2020,WAS,16,7,9,0,0.438,335,329,6
2020,LAC,16,7,9,0,0.438,384,426,-42
2020,NWE,16,7,9,0,0.438,326,353,-27
2020,MIN,16,7,9,0,0.438,430,475,-45
2021,WAS,17,7,10,0,0.412,335,434,-99
2021,SEA,17,7,10,0,0.412,395,366,29
2021,DEN,17,7,10,0,0.412,335,322,13
2021,ATL,17,7,10,0,0.412,313,459,-146
2022,TEN,17,7,10,0,0.412,298,359,-61
2022,NYJ,17,7,10,0,0.412,296,316,-20
2022,NOR,17,7,10,0,0.412,330,345,-15
2022,CLE,17,7,10,0,0.412,361,381,-20
2022,CAR,17,7,10,0,0.412,347,374,-27
2022,ATL,17,7,10,0,0.412,365,386,-21
2023,NYJ,17,7,10,0,0.412,268,355,-87
2023,MIN,17,7,10,0,0.412,344,362,-18
2023,CHI,17,7,10,0,0.412,360,379,-19
2023,ATL,17,7,10,0,0.412,321,373,-52
2024,KAN,7,7,0,0,1,173,123,50
1999,SDG,16,8,8,0,0.5,269,316,-47
1999,BAL,16,8,8,0,0.5,324,277,47
1999,OAK,16,8,8,0,0.5,390,329,61
1999,NYJ,16,8,8,0,0.5,308,309,-1
1999,NWE,16,8,8,0,0.5,299,284,15
1999,GNB,16,8,8,0,0.5,357,341,16
1999,DET,16,8,8,0,0.5,322,323,-1
1999,DAL,16,8,8,0,0.5,352,276,76
1999,CAR,16,8,8,0,0.5,421,381,40
2000,WAS,16,8,8,0,0.5,281,269,12
2000,BUF,16,8,8,0,0.5,315,350,-35
2001,WAS,16,8,8,0,0.5,256,303,-47
2001,DEN,16,8,8,0,0.5,340,339,1
2002,SDG,16,8,8,0,0.5,333,367,-34
2002,KAN,16,8,8,0,0.5,467,399,68
2002,BUF,16,8,8,0,0.5,379,397,-18
2003,NOR,16,8,8,0,0.5,340,326,14
2003,CIN,16,8,8,0,0.5,346,384,-38
2004,STL,16,8,8,0,0.5,319,392,-73
2004,NOR,16,8,8,0,0.5,348,405,-57
2004,MIN,16,8,8,0,0.5,405,395,10
2004,CIN,16,8,8,0,0.5,374,372,2
2005,ATL,16,8,8,0,0.5,351,341,10
2006,STL,16,8,8,0,0.5,367,381,-14
2006,PIT,16,8,8,0,0.5,353,315,38
2006,TEN,16,8,8,0,0.5,324,400,-76
2006,NYG,16,8,8,0,0.5,355,362,-7
2006,JAX,16,8,8,0,0.5,371,274,97
2006,GNB,16,8,8,0,0.5,301,366,-65
2006,CIN,16,8,8,0,0.5,373,331,42
2006,CAR,16,8,8,0,0.5,270,305,-35
2007,PHI,16,8,8,0,0.5,336,300,36
2007,MIN,16,8,8,0,0.5,365,311,54
2007,HOU,16,8,8,0,0.5,379,384,-5
2007,ARI,16,8,8,0,0.5,404,399,5
2008,WAS,16,8,8,0,0.5,265,296,-31
2008,SDG,16,8,8,0,0.5,439,347,92
2008,NOR,16,8,8,0,0.5,463,393,70
2008,HOU,16,8,8,0,0.5,366,394,-28
2008,DEN,16,8,8,0,0.5,370,448,-78
2009,SFO,16,8,8,0,0.5,330,281,49
2009,TEN,16,8,8,0,0.5,354,402,-48
2009,NYG,16,8,8,0,0.5,402,427,-25
2009,DEN,16,8,8,0,0.5,326,324,2
2009,CAR,16,8,8,0,0.5,315,308,7
2010,OAK,16,8,8,0,0.5,410,371,39
2010,JAX,16,8,8,0,0.5,353,419,-66
2011,SDG,16,8,8,0,0.5,406,377,29
2011,OAK,16,8,8,0,0.5,359,433,-74
2011,PHI,16,8,8,0,0.5,396,328,68
2011,NYJ,16,8,8,0,0.5,377,363,14
2005,STL,16,6,10,0,0.375,363,429,-66
2005,BAL,16,6,10,0,0.375,265,299,-34
2004,ARI,16,6,10,0,0.375,284,322,-38
2004,DAL,16,6,10,0,0.375,293,405,-112
2004,DET,16,6,10,0,0.375,296,350,-54
2004,NYG,16,6,10,0,0.375,303,347,-44
2004,WAS,16,6,10,0,0.375,240,265,-25
2003,BUF,16,6,10,0,0.375,243,279,-36
2003,NYJ,16,6,10,0,0.375,283,299,-16
2003,PIT,16,6,10,0,0.375,300,327,-27
2002,JAX,16,6,10,0,0.375,328,315,13
2002,MIN,16,6,10,0,0.375,390,442,-52
2001,CIN,16,6,10,0,0.375,226,309,-83
2001,IND,16,6,10,0,0.375,413,486,-73
2001,JAX,16,6,10,0,0.375,294,286,8
2001,KAN,16,6,10,0,0.375,320,344,-24
2000,SEA,16,6,10,0,0.375,320,405,-85
2000,SFO,16,6,10,0,0.375,388,422,-34
1999,CHI,16,6,10,0,0.375,272,341,-69
1999,ARI,16,6,10,0,0.375,245,382,-137
1999,DEN,16,6,10,0,0.375,314,318,-4
1999,PIT,16,6,10,0,0.375,317,320,-3
2024,ATL,8,5,3,0,0.625,194,195,-1
2024,DEN,8,5,3,0,0.625,173,120,53
2024,MIN,7,5,2,0,0.714,188,137,51
2024,PHI,7,5,2,0,0.714,171,132,39
2024,PIT,7,5,2,0,0.714,161,101,60
2024,BAL,8,5,3,0,0.625,242,209,33
2023,LAC,17,5,12,0,0.294,346,398,-52
2022,DEN,17,5,12,0,0.294,287,359,-72
2022,LAR,17,5,12,0,0.294,307,384,-77
2021,CAR,17,5,12,0,0.294,304,404,-100
2020,CAR,16,5,11,0,0.313,350,402,-52
2020,DEN,16,5,11,0,0.313,323,446,-123
2020,DET,16,5,11,0,0.313,377,519,-142
2019,CAR,16,5,11,0,0.313,340,470,-130
2019,ARI,16,5,10,1,0.344,361,442,-81
2019,MIA,16,5,11,0,0.313,306,494,-188
2019,LAC,16,5,11,0,0.313,337,345,-8
2018,JAX,16,5,11,0,0.313,245,316,-71
2018,NYG,16,5,11,0,0.313,369,412,-43
2018,TAM,16,5,11,0,0.313,396,464,-68
2017,CHI,16,5,11,0,0.313,264,320,-56
2017,DEN,16,5,11,0,0.313,289,382,-93
2017,NYJ,16,5,11,0,0.313,298,382,-84
2017,TAM,16,5,11,0,0.313,335,382,-47
2016,NYJ,16,5,11,0,0.313,275,409,-134
2016,SDG,16,5,11,0,0.313,410,423,-13
2015,JAX,16,5,11,0,0.313,376,448,-72
2015,BAL,16,5,11,0,0.313,328,401,-73
2015,SFO,16,5,11,0,0.313,238,387,-149
2014,CHI,16,5,11,0,0.313,319,442,-123
2013,MIN,16,5,10,1,0.344,391,480,-89
2012,CLE,16,5,11,0,0.313,302,368,-66
2012,ARI,16,5,11,0,0.313,250,357,-107
2011,JAX,16,5,11,0,0.313,243,329,-86
2011,WAS,16,5,11,0,0.313,288,367,-79
2010,CLE,16,5,11,0,0.313,271,332,-61
2010,ARI,16,5,11,0,0.313,289,434,-145
2009,CLE,16,5,11,0,0.313,245,375,-130
2009,OAK,16,5,11,0,0.313,197,379,-182
2009,SEA,16,5,11,0,0.313,280,390,-110
2008,JAX,16,5,11,0,0.313,302,367,-65
2008,OAK,16,5,11,0,0.313,263,388,-125
2007,BAL,16,5,11,0,0.313,275,384,-109
2007,SFO,16,5,11,0,0.313,219,364,-145
2006,ARI,16,5,11,0,0.313,314,389,-75
2006,WAS,16,5,11,0,0.313,307,376,-69
2005,BUF,16,5,11,0,0.313,271,367,-96
2005,ARI,16,5,11,0,0.313,311,387,-76
2005,DET,16,5,11,0,0.313,254,345,-91
2004,CHI,16,5,11,0,0.313,231,331,-100
2004,TEN,16,5,11,0,0.313,344,439,-95
2004,OAK,16,5,11,0,0.313,320,442,-122
2004,TAM,16,5,11,0,0.313,301,304,-3
2003,ATL,16,5,11,0,0.313,299,422,-123
2003,CLE,16,5,11,0,0.313,254,322,-68
2003,DET,16,5,11,0,0.313,270,379,-109
2003,HOU,16,5,11,0,0.313,255,380,-125
2003,JAX,16,5,11,0,0.313,276,331,-55
2003,WAS,16,5,11,0,0.313,287,372,-85
2002,ARI,16,5,11,0,0.313,262,417,-155
2002,DAL,16,5,11,0,0.313,217,329,-112
2001,DAL,16,5,11,0,0.313,246,338,-92
2001,MIN,16,5,11,0,0.313,290,390,-100
2001,SDG,16,5,11,0,0.313,332,321,11
2000,CHI,16,5,11,0,0.313,216,355,-139
2000,DAL,16,5,11,0,0.313,294,361,-67
2000,NWE,16,5,11,0,0.313,276,338,-62
1999,ATL,16,5,11,0,0.313,285,380,-95
1999,PHI,16,5,11,0,0.313,272,357,-85
2024,CHI,7,4,3,0,0.571,163,119,44
2024,IND,8,4,4,0,0.5,175,172,3
2024,ARI,8,4,4,0,0.5,178,205,-27
2024,LAC,7,4,3,0,0.571,132,91,41
2024,SEA,8,4,4,0,0.5,190,195,-5
2024,SFO,8,4,4,0,0.5,210,182,28
2024,TAM,8,4,4,0,0.5,235,213,22
2023,ARI,17,4,13,0,0.235,330,455,-125
2023,NWE,17,4,13,0,0.235,236,366,-130
2023,WAS,17,4,13,0,0.235,329,518,-189
2022,IND,17,4,12,1,0.265,289,427,-138
2022,ARI,17,4,13,0,0.235,340,449,-109
2021,HOU,17,4,13,0,0.235,280,452,-172
2021,NYG,17,4,13,0,0.235,258,416,-158
2021,NYJ,17,4,13,0,0.235,310,504,-194
2020,ATL,16,4,12,0,0.25,396,414,-18
2020,CIN,16,4,11,1,0.281,311,424,-113
2020,HOU,16,4,12,0,0.25,384,464,-80
2020,PHI,16,4,11,1,0.281,334,418,-84
2019,NYG,16,4,12,0,0.25,341,451,-110
2018,NYJ,16,4,12,0,0.25,333,441,-108
2018,OAK,16,4,12,0,0.25,290,467,-177
2018,SFO,16,4,12,0,0.25,342,435,-93
2017,IND,16,4,12,0,0.25,263,404,-141
2017,HOU,16,4,12,0,0.25,338,436,-98
2016,LAR,16,4,12,0,0.25,224,394,-170
2015,DAL,16,4,12,0,0.25,275,374,-99
2015,SDG,16,4,12,0,0.25,320,398,-78
2014,NYJ,16,4,12,0,0.25,283,401,-118
2014,WAS,16,4,12,0,0.25,301,438,-137
2013,ATL,16,4,12,0,0.25,353,443,-90
2013,CLE,16,4,12,0,0.25,308,406,-98
2013,JAX,16,4,12,0,0.25,247,449,-202
2013,OAK,16,4,12,0,0.25,322,453,-131
2013,TAM,16,4,12,0,0.25,288,389,-101
2012,DET,16,4,12,0,0.25,372,437,-65
2012,PHI,16,4,12,0,0.25,280,444,-164
2012,OAK,16,4,12,0,0.25,290,443,-153
2011,CLE,16,4,12,0,0.25,218,307,-89
2011,TAM,16,4,12,0,0.25,287,494,-207
2010,BUF,16,4,12,0,0.25,283,425,-142
2010,CIN,16,4,12,0,0.25,322,395,-73
2010,DEN,16,4,12,0,0.25,344,471,-127
2009,KAN,16,4,12,0,0.25,294,424,-130
2009,WAS,16,4,12,0,0.25,266,336,-70
2008,CIN,16,4,11,1,0.281,204,364,-160
2008,CLE,16,4,12,0,0.25,232,350,-118
2008,SEA,16,4,12,0,0.25,294,392,-98
2007,ATL,16,4,12,0,0.25,259,414,-155
2007,KAN,16,4,12,0,0.25,226,335,-109
2007,NYJ,16,4,12,0,0.25,268,355,-87
2007,OAK,16,4,12,0,0.25,283,398,-115
2006,CLE,16,4,12,0,0.25,238,356,-118
2006,TAM,16,4,12,0,0.25,211,353,-142
2005,GNB,16,4,12,0,0.25,298,344,-46
2005,NYJ,16,4,12,0,0.25,240,355,-115
2005,TEN,16,4,12,0,0.25,299,421,-122
2005,OAK,16,4,12,0,0.25,290,383,-93
2005,SFO,16,4,12,0,0.25,239,428,-189
2004,CLE,16,4,12,0,0.25,276,390,-114
2004,MIA,16,4,12,0,0.25,275,354,-79
2003,ARI,16,4,12,0,0.25,225,452,-227
2003,NYG,16,4,12,0,0.25,243,387,-144
2003,OAK,16,4,12,0,0.25,270,379,-109
2003,SDG,16,4,12,0,0.25,313,441,-128
2002,CHI,16,4,12,0,0.25,281,379,-98
2002,HOU,16,4,12,0,0.25,213,356,-143
2000,ATL,16,4,12,0,0.25,252,413,-161
2000,CIN,16,4,12,0,0.25,185,359,-174
1999,CIN,16,4,12,0,0.25,283,460,-177
1999,SFO,16,4,12,0,0.25,295,453,-158
2024,CIN,8,3,5,0,0.375,195,203,-8
2024,DAL,7,3,4,0,0.429,150,198,-48
2024,LAR,7,3,4,0,0.429,144,174,-30
2022,CHI,17,3,14,0,0.176,326,463,-137
2022,HOU,17,3,13,1,0.206,289,420,-131
2021,DET,17,3,13,1,0.206,325,467,-142
2021,JAX,17,3,14,0,0.176,253,457,-204
2019,DET,16,3,12,1,0.219,341,423,-82
2019,WAS,16,3,13,0,0.188,266,435,-169
2018,ARI,16,3,13,0,0.188,225,425,-200
2017,NYG,16,3,13,0,0.188,246,388,-142
2016,CHI,16,3,13,0,0.188,279,399,-120
2016,JAX,16,3,13,0,0.188,318,400,-82
2015,CLE,16,3,13,0,0.188,278,432,-154
2015,TEN,16,3,13,0,0.188,299,423,-124
2014,JAX,16,3,13,0,0.188,249,412,-163
2014,OAK,16,3,13,0,0.188,253,452,-199
2013,WAS,16,3,13,0,0.188,334,478,-144
2011,MIN,16,3,13,0,0.188,340,449,-109
2009,TAM,16,3,13,0,0.188,244,400,-156
2007,STL,16,3,13,0,0.188,263,438,-175
2006,DET,16,3,13,0,0.188,305,398,-93
2005,NOR,16,3,13,0,0.188,235,398,-163
2002,DET,16,3,13,0,0.188,306,451,-145
2001,BUF,16,3,13,0,0.188,265,420,-155
2000,CLE,16,3,13,0,0.188,161,419,-258
2000,ARI,16,3,13,0,0.188,210,443,-233
1999,NOR,16,3,13,0,0.188,260,434,-174
2024,CLE,8,2,6,0,0.25,138,186,-48
2024,JAX,8,2,6,0,0.25,172,224,-52
2024,MIA,7,2,5,0,0.286,97,157,-60
2024,NOR,8,2,6,0,0.25,185,206,-21
2024,NWE,8,2,6,0,0.25,124,197,-73
2024,NYG,7,2,5,0,0.286,99,149,-50
2024,NYJ,8,2,6,0,0.25,150,170,-20
2024,LVR,8,2,6,0,0.25,144,210,-66
2023,CAR,17,2,15,0,0.118,236,416,-180
2020,NYJ,16,2,14,0,0.125,243,457,-214
2019,CIN,16,2,14,0,0.125,279,420,-141
2016,SFO,16,2,14,0,0.125,309,480,-171
2014,TEN,16,2,14,0,0.125,254,438,-184
2014,TAM,16,2,14,0,0.125,277,410,-133
2013,HOU,16,2,14,0,0.125,276,428,-152
2012,JAX,16,2,14,0,0.125,255,444,-189
2012,KAN,16,2,14,0,0.125,211,425,-214
2011,IND,16,2,14,0,0.125,243,430,-187
2011,STL,16,2,14,0,0.125,193,407,-214
2010,CAR,16,2,14,0,0.125,196,408,-212
2009,DET,16,2,14,0,0.125,262,494,-232
2008,KAN,16,2,14,0,0.125,291,440,-149
2008,STL,16,2,14,0,0.125,232,465,-233
2006,OAK,16,2,14,0,0.125,168,332,-164
2005,HOU,16,2,14,0,0.125,260,431,-171
2004,SFO,16,2,14,0,0.125,259,452,-193
2002,CIN,16,2,14,0,0.125,279,456,-177
2001,DET,16,2,14,0,0.125,270,424,-154
1999,CLE,16,2,14,0,0.125,217,437,-220
2024,CAR,8,1,7,0,0.125,124,271,-147
2024,TEN,7,1,6,0,0.143,120,196,-76
2020,JAX,16,1,15,0,0.063,306,492,-186
2016,CLE,16,1,15,0,0.063,264,452,-188
2009,STL,16,1,15,0,0.063,175,436,-261
2007,MIA,16,1,15,0,0.063,267,437,-170
2001,CAR,16,1,15,0,0.063,253,410,-157
2000,SDG,16,1,15,0,0.063,269,440,-171
2017,CLE,16,0,16,0,0,234,410,-176
2008,DET,16,0,16,0,0,268,517,-249
